111111111111111
10P000E0C0000001
111111111111111