111111111111111
1000000C0000001
100000C00000011
1000000PE000001
111111111111111